Аа - Aa			
Бб - SU	
Вв - Bb		
Гг - Gg		
Дд - Dd		
Ее - Ee		
Ёё - Ee		
Жж - s		
Зз - 3z	(три,z)	
Ии - I&	(большая I, знак "Энд" &)	
Йй - j (только строчная)	
Кк - Kk		
Лл - Ll		
Мм - Mm		
Нн - Hh	
Оо - Oo	
Пп - Nn	
Рр - Pp
Сс - Cc	
Тт - Tt	
Уу - Yy	
Фф - Ff	
Хх - Xx	
ц - u	
Чч - Vv	
ш - w	
щ - W
Ш - нет
Щ - нет	
ъ - нет	
ы - J (только строчная)
ь - i (только строчная)
Ээ - 'Z (апостроф, большая Z)
Юю - Qq	
Яя - Rr	

PS: Й, Ш, Щ, Ы, Ь, Ъ, ъ, Ж, Ц - остаются оригинальными
— « » искать на всякий случай, особенно, если сразу не работает